7222221271
6463754232
3373484684
4674461265
1187834788
1175316351
8211411846
4657828333
5286325337
5771324832
